000000000000000000000000000000000000000
011111111111111111111111111111111111110
011111111111110011111111111111111111110
011001111111111111111111111111111111110
011111111111110011111111111111111111110
011111111111111111111111111111111111110
011111111111111111111111111111111111110
011111110011111111111111111111111111110
011111111111111111111111111111111111110
011111111111111111111111111111111111110
000000000000000000000000000000000000000
